Verb	English	Tags	Notes
HABLAR	to speak	tier:1;word-type:verb;verb-type:ar;regularity:regular	Model regular -ar verb
COMER	to eat	tier:1;word-type:verb;verb-type:er;regularity:regular	Model regular -er verb
VIVIR	to live	tier:1;word-type:verb;verb-type:ir;regularity:regular	Model regular -ir verb
SER	to be	tier:1;word-type:verb;verb-type:er;regularity:highly-irregular;copula:true	Permanent state/identity
ESTAR	to be	tier:1;word-type:verb;verb-type:ar;regularity:highly-irregular;copula:true	Temporary state/location
TENER	to have	tier:1;word-type:verb;verb-type:er;regularity:irregular;stem-change:e-ie;verb-tense:future:irregular	Essential possession verb
IR	to go	tier:1;word-type:verb;verb-type:ir;regularity:highly-irregular	Essential motion verb
HACER	to do/make	tier:1;word-type:verb;verb-type:er;regularity:irregular;yo-form:irregular;verb-tense:preterite:irregular;verb-tense:future:irregular	Very common action verb
PODER	to be able/can	tier:1;word-type:verb;verb-type:er;regularity:irregular;stem-change:o-ue;verb-tense:future:irregular	Modal verb
QUERER	to want/love	tier:1;word-type:verb;verb-type:er;regularity:irregular;stem-change:e-ie;verb-tense:future:irregular	Essential desire verb
TOMAR	to take/drink	tier:1;word-type:verb;verb-type:ar;regularity:regular	Essential verb: beverages, transportation, classes, medicine
LLAMARSE	to be called/named	tier:2;word-type:verb;verb-type:ar;regularity:regular;reflexive:true	Essential identity (¿Cómo te llamas?)
LEVANTARSE	to get up/stand up	tier:2;word-type:verb;verb-type:ar;regularity:regular;reflexive:true	Morning routine essential
SENTARSE	to sit down	tier:2;word-type:verb;verb-type:ar;regularity:irregular;stem-change:e-ie;reflexive:true	Very common action
ACOSTARSE	to go to bed	tier:2;word-type:verb;verb-type:ar;regularity:irregular;stem-change:o-ue;reflexive:true	Evening routine essential
DESPERTARSE	to wake up	tier:2;word-type:verb;verb-type:ar;regularity:irregular;stem-change:e-ie;reflexive:true	Morning routine essential
DUCHARSE	to shower/bathe	tier:2;word-type:verb;verb-type:ar;regularity:regular;reflexive:true	Hygiene essential
LAVARSE	to wash oneself	tier:2;word-type:verb;verb-type:ar;regularity:regular;reflexive:true	Daily hygiene verb
LAVAR	to wash	tier:2;word-type:verb;verb-type:ar;regularity:regular	Essential cleaning verb
PONERSE	to put on/become	tier:2;word-type:verb;verb-type:er;regularity:irregular;yo-form:irregular;verb-tense:preterite:irregular;verb-tense:future:irregular;reflexive:true	From PONER (clothing/state change)
VESTIRSE	to get dressed	tier:2;word-type:verb;verb-type:ir;regularity:irregular;stem-change:e-i;verb-tense:preterite:stem-change:e-i;reflexive:true	Morning routine essential
QUEDARSE	to stay/remain	tier:2;word-type:verb;verb-type:ar;regularity:regular;reflexive:true	Very versatile verb
IRSE	to leave/go away	tier:3;word-type:verb;verb-type:ir;regularity:highly-irregular;reflexive:true	From IR (highly irregular)
VENIR	to come	tier:3;word-type:verb;verb-type:ir;regularity:irregular;stem-change:e-ie;verb-tense:preterite:irregular;verb-tense:future:irregular	Essential motion verb (pairs with IR)
PONER	to put/place	tier:3;word-type:verb;verb-type:er;regularity:irregular;yo-form:irregular;verb-tense:preterite:irregular;verb-tense:future:irregular	Essential placement verb
SALIR	to leave/go out	tier:3;word-type:verb;verb-type:ir;regularity:irregular;yo-form:irregular;verb-tense:future:irregular	Essential motion verb
DAR	to give	tier:3;word-type:verb;verb-type:ar;regularity:highly-irregular	Essential transfer verb
VER	to see	tier:3;word-type:verb;verb-type:er;regularity:irregular;yo-form:irregular	Essential perception verb
DECIR	to say/tell	tier:3;word-type:verb;verb-type:ir;regularity:irregular;stem-change:e-i;yo-form:irregular;verb-tense:preterite:irregular;verb-tense:future:irregular	Essential communication verb
SABER	to know	tier:3;word-type:verb;verb-type:er;regularity:irregular;yo-form:irregular;verb-tense:preterite:irregular;verb-tense:future:irregular	Knowledge of facts
OÍR	to hear	tier:3;word-type:verb;verb-type:ir;regularity:highly-irregular;spelling-change:true	Essential perception verb
TRAER	to bring	tier:3;word-type:verb;verb-type:er;regularity:irregular;yo-form:irregular;verb-tense:preterite:irregular	Essential transfer verb (pairs with LLEVAR)
CREER	to believe	tier:3;word-type:verb;verb-type:er;regularity:regular;spelling-change:preterite	Vowel change in preterite
NECESITAR	to need	tier:4;word-type:verb;verb-type:ar;regularity:regular	Essential necessity verb
LLEVAR	to take/carry/wear	tier:4;word-type:verb;verb-type:ar;regularity:regular	Essential transfer/possession verb
PENSAR	to think	tier:4;word-type:verb;verb-type:ar;regularity:irregular;stem-change:e-ie	Essential cognition verb
ENTENDER	to understand	tier:4;word-type:verb;verb-type:er;regularity:irregular;stem-change:e-ie	Essential comprehension verb
SENTIR	to feel	tier:4;word-type:verb;verb-type:ir;regularity:irregular;stem-change:e-ie;verb-tense:preterite:stem-change:e-i	Essential emotion verb
SENTIRSE	to feel	tier:4;word-type:verb;verb-type:ir;regularity:irregular;stem-change:e-ie;verb-tense:preterite:stem-change:e-i;reflexive:true	From SENTIR (emotions)
CONOCER	to know/be familiar with	tier:4;word-type:verb;verb-type:er;regularity:irregular;yo-form:zco	Knowledge of people/places
ENCONTRAR	to find	tier:4;word-type:verb;verb-type:ar;regularity:irregular;stem-change:o-ue	Essential discovery verb
ENCONTRARSE	to meet	tier:4;word-type:verb;verb-type:ar;regularity:irregular;stem-change:o-ue;reflexive:true	Common interaction verb
PREOCUPARSE	to worry	tier:4;word-type:verb;verb-type:ar;regularity:regular;reflexive:true	Common emotion verb
DIVERTIRSE	to have fun/enjoy oneself	tier:4;word-type:verb;verb-type:ir;regularity:irregular;stem-change:e-ie;verb-tense:preterite:stem-change:e-i;reflexive:true	Common leisure verb
GUSTAR	to like/please	tier:5;word-type:verb;verb-type:ar;regularity:regular;special-construction:indirect-object	Reverse subject construction
ENCANTAR	to love/enchant	tier:5;word-type:verb;verb-type:ar;regularity:regular;special-construction:indirect-object	Stronger than gustar
MOLESTAR	to bother/annoy	tier:5;word-type:verb;verb-type:ar;regularity:regular;special-construction:indirect-object	Common irritation verb
IMPORTAR	to matter/care	tier:5;word-type:verb;verb-type:ar;regularity:regular;special-construction:indirect-object	Essential concern verb
FALTAR	to lack/be missing	tier:5;word-type:verb;verb-type:ar;regularity:regular;special-construction:indirect-object	Essential need/absence verb
DOLER	to hurt/ache	tier:5;word-type:verb;verb-type:er;regularity:irregular;stem-change:o-ue;special-construction:indirect-object	Essential pain/discomfort verb
PARECER	to seem/appear	tier:5;word-type:verb;verb-type:er;regularity:irregular;yo-form:zco;special-construction:indirect-object	Essential opinion verb
